循环活动 - Gói luyện (sheet 14 -> 16 ).
循环七天乐 - Quà 7 ngày.
装备周卡 - Trang bị ( trang bị tuần thẻ).
循环活动表二 - Yamato (ngọc tuần thẻ- sheet 9 -> 11).中元夜
符文周卡 - Tướng 13 (Haki tuần thẻ).
兽魂祈祷UP - Ngọc (Ngọc UP - Nâng cấp ngọc).
超值首充 - Siêu nạp.
寻宝 - Vòng quay.
跨服充值排行 - BXH nạp liên sv.
暑期狂欢 - Hoa xuân.
多多益善 - Càng nhiều(càng nhiều càng tốt) (thay quà tại 任务 sheet1 - mã 660001).
循环活动表二 - đập trứng (sheet 6 -> 8 ).
乾坤宝匣 - Bảo hộp (cận thiên bảo hộp).
芬芳赠礼 - Tặng lễ.
植树节 - Cây.
魔术戏法 - Ma thuật.
仲春之月 - Mùa xuân.
春节活动 - Năm mới.
圣诞树 - Cây thông noel.
宝青坊 - Skin (Hạn lúc làn da diễn tiếp).
宝青坊 - Bảo khố.
连续充值 - Quà nạp (liên tục nạp tiền).
欢度中秋 - Chopper.
神龙战令-Thần Long(thu phục rồng lửa).
中元夜 - Lễ hội
Bách Trửu - comming soon...
端午龙舟 - Thuyền rồng.
元宵喜乐-nguyên tiêu
循环商城-shop trong cac sk (sheet 3).
物品表-item

----chưa mở----
新英雄上新活动 - Thí luyện.
跨服元宝排行 - BXH tiêu.

通用-id chức năng
充值项-giá các gói mua

充值项-gói mua thần long